############
#        O #
#   P   ####
#     OX   #
#  XO      #
#  O ##    #
#    ##    #
#    OO    #
#       XX #
#  X  X #  #
##      ####
 ########
 